
NO ./mandatory/textures/north.xpm
SO  ./mandatory/textures/south.xpm
WE ./mandatory/textures/west.xpm
C      100,100,100


EA ./mandatory/textures/east.xpm


F   0,191,255



1111
10N01
1111



