NO ./mandatory/textures/north.xpm
SO  ./mandatory/textures/south.xpm
WE ./mandatory/textures/west.xpm


EA ./mandatory/textures/east.xpm
F 164,169,20
C 153,204,255

 1111111111111111111
101000001000000000001
101110101110101110111
101000100000100010101
101011111111111010101
101010000000000010001
101010111011111111101
101N00001000000000001
 1111111111111111111
